11111111111111111
10022222222222001
10121010101012101
12222222222222221
12121010101012121
12222222222222221
12121010101012121
12222222222222221
12121010101012121
12222222222222221
10121010101012101
10022222222222001
11111111111111111